00000000110100000000
00111000100000100000
00100110001100100110
00000011101100000110
00110011100001110000
00110000000111011110
00000010000111011110
00001011110111011110
00001001000000000000
00001101001111000000
00000101101111000000
01110000101111000000
01110011101111000000
01110011100001010000
11000111111001000010
00000011100001110000
00000011100001111000
01100011101100001110
01101000000100000000
00000000000000000000
